........................
...._....___..___.___...
...._..._..._._..._.....
...._..._..._.___.___...
...._..._..._..._._.....
....___..___..___.___...
........................
........................
........................
........................