..___...___.._..._.____.
._....._..._.__.__._....
._.__.._____._._._.____.
._..._._..._._..._._....
..___.._..._._..._.____.
..XXX..X...X.XXXXX.XXXX.
.X...X.X...X.X.....X..X.
.X...X.X...X.XXXXX.XXX..
.X...X..X.X..X.....X..X.
..XXX....X...XXXXX.X..X.