________________________
....................X...
...........O.O......X...
......BBB....B......X...
........O..B..B.........
......O....B...B........
....O......B....X.......
.....BBB.......X........
H.............X.........
________________________