________________SS______
......B..........B..X...
......B....O.....B..X...
...B..B....O..B..B..X...
...B..B...O...B..B..X...
...B..B...O...B..B..X...
...B..B..O....B..B......
...B.....O....B.........
H..B..........B.....X...
________________________