________________________
...BBBBXXXBBB....X...X..
.....O..X..O.........X..
..............O....O.X..
.....X..O..X.....B.O....
....BXBBBBXBB....B.O....
..............O....O.X..
.....................X..
H..BBBBXXBBBB....X...X..
________________________