__________________
.X...B............
.X...B.......OO...
.X...B..BBB.....B.
...............B..
......OOO.....B...
................X.
.........XXX...X..
.H............X...
__________________