________________________
....................X...
...B.........O......X...
...B..BBB...........X...
...B..........B.........
......O.O.O..B..........
............B....X......
..O...XXX.........X.....
H..................X...
________________________