________________________
.......X..........XXX...
.......X...O.O..........
...BBB.X........B.......
........O..B...B........
......O....B..B.........
....O.B....B...X........
......B.......X.........
H.....B......X..........
________________________