________________________
...BBBBXXBBBB....X...X..
.....O..X..O.........X..
..............O....O.X..
.....X..O..X.....X.O....
....BXBXXBXXB....X.O....
..............O....O.X..
.....................X..
H..BBBXXBBBBB....X...X..
________________________