......................X.
......................X.
......OOO.............X.
.........OO.....X.....X.
.........XXXX..X........
.H............X.........
________________________