......................X.............
......................X.............
......OOO.............X.............
.........OO.....X..........B.......B
.........XXX...X............B......B
.H............X..............B.BBB.B
____________________________________