....................................
..............................B.....
.............OO...............B.....
........BBB...........X.......B.....
......................X.............
......OOO.............X.............
................X..........B........
.........XXX...X............B.......
.H............X..............B......
____________________________________