________________________
...BBBBXXXBBB....X...X..
.....O..X..O.........X..
..............O....O.X..
.....X..O..X.....X.O....
....BXBBBBXBB....X.O....
..............O....O.X..
.....................X..
H..BBBBXXBBBB....X...X..
________________________