________________________
...B....................
...B.......O.O..........
...B....BBB....B....X...
..............B.....X...
....O.O.O....B......X...
................X.......
.........XXX...X........
H.............X.........
________________________