________________________
....OOOOOOOOOOOOOOOO....
....OOOOOOOOOOOOOOOO....
....OO...OOOOOO...OO....
....OO...OOOOOO...OO....
....OOOOOOOOOOOOOOOO....
....OOOOO.OOOO.OOOOO....
....OOOOO......OOOOO....
H...OOOOOOOOOOOOOOOO....
________________________