________________________
...OOOOOOOOOOOOOOOOOO...
...OOOOOOOOOOOOOOOOOO...
...OO....OOOOOO....OO...
...OO....OOOOOO....OO...
...OOOOOOOOOOOOOOOOOO...
...OOOO.OOOOOOOO.OOOO...
...OOOO..........OOOO...
H..OOOOOOOOOOOOOOOOOO...
________________________