________________________
....OOOOOOOOOOOOOOOO....
....OOOOOOOOOOOOOOOO....
....OOOOOOOOOOOOOOOO....
....OOOOOOOOOOOOOOOO....
....OOOOOOOOOOOOOOOO....
....OOOOOOOOOOOOOOOO....
....OOOOOOOOOOOOOOOO....
H...OOOOOOOOOOOOOOOO....
________________________